11111111111111111111111111111111111111111111111
1E1000000000000000000000000000000000000000000C1
1P101111111111111111111111111111111111111111111
10100000000000000000000000000000000000000000001
10111111111111111111111111111111111111111111101
10000001000100010001000100010001000100010001001
10111100010001000100010001000100010001000100001
101C0111111111111111111111111111111111111111101
10100100000000000000000000000000000000000000001
10110101011111111111111111111111111111111111101
10000101010000000000000000000000000000000000001
11111101C10111111111111111111111111111111111101
10000001110000000000001C00000000000000000000001
10111111111111111111101111111111111111111111101
1C1C000000000000000000000000000000000000000C1C1
11111111111111111111111111111111111111111111111