11111111111111111111111111111111111111
1C000000000CC0000000000000000000000001
11000000000H1H000000000000000000000001
100111111111H1000000000000000000000001
10000000000C10000000000000000000000001
101111H1111CH00000000000000000000000E1
100000000C1C10000000000000000000000011
11111111111CH0000000000000000000000001
1P000000000C10000000000000000000000001
11111111111111111111111111111111111111