111111111111111111111111111111111111111111
1C00000000000000000000000000000000000000P1
111111111111111111111111111111111111110001
1C0000000000000000000000000000000000000001
111111111111111111111111111111111111001101
1C000000000000000000000000000000000001C001
111111111111111111111111111111110011111101
1000000000000000000000000000000001C0000001
101111111111111111111111111111001111111101
100000000000000000000000000C1001C000000001
101111111111111111111111111100111111111101
1000000000000000000000000C1001C00000000001
10111111111111111111111111001C000000000001
10000000000000000000000C100111111111111101
101111111111111111111111001C00000000000001
10000000000000C111111100011111111111111101
1011111111111110000000011C0000000000000001
100000000000C10011111111111111111111111101
1011111111111001C0000000000000000000000001
1000000C1000001111111111111111111111111101
10111111001111C000000000000000000000000001
10000C100111111111111111111111111111111101
101111001C00000000000000000000000000000001
100C10011111111111111111111111111111111101
1EC1001C0000000000000000000000000000000001
111001111111111111111111111111111111111101
1C001C000000000000000000000000000000000001
111111111111111111111111111111111111111111