1111111111111
10P00000C10E1
1111111111111