11111111111111111111111111111111111111111111111
10000000000000000000000000000000000000000000001
10000000000000000000000000000000000000000000001
10000011000110001111111000111110000000000000001
10000010101010000001000000100000000000P00000001
1000001001001000000100000011110000000CEC0000001
10000010000010000001000000100000000000100000001
10000010000010000001000000100000000000000000001
10000000000000000000000000000000000000000000001
11111111111111111111111111111111111111111111111