11111111111111111111111111111111111111111111111111
1P00000000010C100000000000C00010000100000000E1C001
11111000000101110111111111110110111101111111111101
10000000000000000000000000000000000000000000000001
10111111111111111111111111111111111111111111111111
10000000000000000000000000000000000000000000000001
11111111111111111111111111111111111111111111111101
10000000000000000000000000000000000000000000000001
10111111111111111111111111111111111111111111111111
10000000000000000000000000000000000000000000000001
11111111111111111111111111111111111111111111111101
10000000000000000000000000000000000000000000000001
10111111111111111111111111111111111111111111111111
10000000000000000000000000000000000000000000000001
11111111111111111111111111111111111111111111111101
10000000000000000000000000000000000000000000000001
10111111111111111111111111111111111111111111111111
100000000000000000000000000000000000000000000000C1
11111111111111111111111111111111111111111111111111